[APP NAME] = SMS BTMAPC 
[SCOPE] = PLUTO, COSMOS
[MODULE] = MOD_MMI_COMMON_APP
TRC_MSG(TRC_MMI_SMS_BT_ENTER_GET_NUM_HDLR,	            "[SMSBT]mmi_sms_um_bt_get_num_req_hdlr()")
TRC_MSG(TRC_MMI_SMS_BT_UNREAD_MSG_NUM,	            "[SMSBT]rsp->inbox_unread_msg_number = %d")
TRC_MSG(TRC_MMI_SMS_BT_INBOX_MSG_NUM,	            "[SMSBT]rsp->inbox_msg_number = %d")
TRC_MSG(TRC_MMI_SMS_BT_UNSENT_MSG_NUM,	            "[SMSBT]rsp->unsent_msg_number = %d")
TRC_MSG(TRC_MMI_SMS_BT_SENT_MSG_NUM,	            "[SMSBT]rsp->sent_msg_number = %d")
TRC_MSG(TRC_MMI_SMS_BT_DRAFT_MSG_NUM,	            "[SMSBT]rsp->draft_msg_number = %d")
TRC_MSG(TRC_MMI_SMS_BT_MSG_ENTRY_SENT,	            "mmi_sms_um_bt_ui_sh_main_msg_entry_sent")
TRC_MSG(TRC_MMI_SMS_BT_MSG_ENTRY_DRAFT,	            "mmi_sms_um_bt_ui_sh_main_msg_entry_sent")
TRC_MSG(TRC_MMI_SMS_BT_MSG_SEND_GET_LIST_REQ,	            "[SMSBT] Called srv_sms_btmapc_get_msg_list, from FSeditor")
TRC_MSG(TRC_MMI_SMS_BT_MSG_SEND_GET_LIST_RSP,	            "[SMSBT] calback mmi_sms_bt_set_box_rsp_handler called result = %d")
TRC_MSG(TRC_MMI_SMS_BT_MSG_SEND_GET_SEND_RSP,	            "[SMSBT] calback mmi_sms_bt_send_rsp_handler called result = %d")
TRC_MSG(TRC_MMI_SMS_BT_MSG_SEND_CLOSE_PROGRESS_SCREEN,	            "[SMSBT] close progress screen")TRC_MSG(TRC_MMI_SMS_BT_MSG_SEND_CALL_VIEWER,	            "[SMSBT] Call viewer, g_sms_bt_gid = %d")
TRC_MSG(TRC_MMI_SMS_BT_MSG_VIEWER_ACTIVE_GROUP,	            "[SMSBT] Entry viewer, active group = %d")
TRC_MSG(TRC_MMI_SMS_BT_MSG_VIEWER_SMS_GROUP,	            "[SMSBT] Entry viewer, g_sms_bt_gid = %d")
TRC_MSG(TRC_MMI_SMS_BT_MSG_VIEWER_ENTRY,	            "[SMSBT] Entry viewer succesful")
TRC_MSG(TRC_MMI_SMS_BT_MSG_GET_MSG_CB,	            "mmi_sms_bt_get_msg_cb result =%d")
TRC_MSG(TRC_MMI_SMS_BT_MSG_SEND_READ_MSG_REQ,	            "srv_sms_btmapc_read_msg")
TRC_MSG(TRC_MMI_SMS_BT_MSG_READ_MSG_CB,	            "mmi_sms_bt_get_msg_callback callback_data->result =%d")
TRC_MSG(TRC_MMI_SMS_BT_MSG_EDITOR_SCREEN_DEINIT,	            "[SMSBT]mmi_sms_bt_editor_scrn_leave_proc EVT_ID_SCRN_DEINIT: free msg_data")
TRC_MSG(TRC_MMI_SMS_BT_MSG_DELETE_MSG_CB,	            "[SMSBT]mmi_sms_bt_viewer_opt_delete_callback result =%d")
TRC_MSG(TRC_MMI_SMS_BT_MSG_SET_BOX_RSP_HANDLER,	            "[SMSBT]mmi_sms_bt_set_box_rsp_handler data->result =%d")
TRC_MSG(TRC_MMI_SMS_BT_MSG_SEND_RSP_HANDLER,	            "[SMSBT]mmi_sms_bt_send_rsp_handler data->result =%d")
TRC_MSG(TRC_MMI_SMS_BT_MSG_GET_BOX_NUMBER,	            "[SMSBT]mmi_sms_um_bt_ui_sh_main_msg_entry_folder msg_box =%d  number=%d")
TRC_MSG(TRC_MMI_SMS_BT_MSG_GET_SHIFT_EVT,	            "[SMSBT]mmi_sms_um_bt_deinit_grp_cntx_on_shift")